1110001111111111001
1110011111001111001
1100011111001111001
0000111111000111100
1111111111100011100
1111111111110001100
1110011111111001111
1110011111111111111
1110001111100111100
1100001110001111000
1100011100111110011
0000111000111110011
0000111001110110011
1111110001110110011
1111111111111111000
1111110000000111111
1111110000000111111
0001111111100000011
1100111111100000011
1100111111111110011